7  7  7  7  7  7  7  7  7  7  7  7  7  7  7  7  7  7  7  7
2  2  2  3  7  7  7  7  7  7  7  7  7  7  7  7  7  7  7  7
15 15 15 8  7  7  7  7  7  7  7  7  7  7  7  7  7  7  7  7
12 5  15 9  2  2  2  2  2  3  7  7  7  7  7  7  7  7  7  7
7  6  15 15 15 15 15 15 15 8  7  7  7  1  2  2  2  2  2  2
7  11 12 12 12 12 12 5  15 8  7  7  7  6  15 15 15 15 15 15
7  7  7  7  7  7  7  6  15 8  7  7  7  6  15 4  12 12 12 12
7  7  7  7  7  7  7  6  15 8  1  2  2  10 15 8  7  7  7  7
7  7  7  7  7  7  7  6  15 8  6  15 15 15 15 8  7  7  7  7
7  7  7  7  7  7  7  6  15 9  10 15 4  12 12 13 7  7  7  7
7  7  7  7  7  7  7  6  15 15 15 15 8  7  7  7  7  7  7  7
7  7  7  7  7  7  7  11 12 12 12 12 13  7  7  7  7  7  7  7