6  6  6  6  6  6  6  3  11 11 11 11 11 11 4  6  6  6  6  6
11 11 11 4  6  6  6  7  0  1  1  1  1  2  5  6  6  6  6  6
1  1  2  5  6  6  6  7  5  6  6  6  6  7  5  6  6  6  6  6
6  6  7  5  6  6  6  7  5  6  6  6  6  7  5  6  6  6  6  6
6  6  7  5  6  6  6  7  5  6  6  6  6  7  5  6  6  6  6  6
6  6  7  5  6  6  6  7  5  6  6  6  6  7  5  6  6  6  6  6
6  6  7  5  6  6  6  7  5  6  6  6  6  7  5  6  6  6  6  6
6  6  7  5  6  6  6  7  5  6  6  6  6  7  10 11 11 11 11 11
6  6  7  5  6  6  6  7  5  6  6  6  6  8  1  1  1  1  1  1
6  6  7  10 11 11 11 12 5  6  6  6  6  6  6  6  6  6  6  6
6  6  8  1  1  1  1  1  9  6  6  6  6  6  6  6  6  6  6  6
6  6  6  6  6  6  6  6  6  6  6  6  6  6  6  6  6  6  6  6