6	6	6	6	6	6	6	3	11	11	11	11	11	11	4	6	6	6	6	6
11	11	11	4	6	6	6	7	0	1	1	1	1	2	5	6	6	6	6	6
1	1	2	5	6	6	6	7	5	6	6	6	6	7	5	6	6	6	6	6
6	6	7	5	6	6	6	7	5	6	6	6	6	7	5	6	6	6	6	6
6	6	7	5	6	6	6	7	5	6	6	6	6	7	5	6	6	6	6	6
6	6	7	5	6	6	6	7	5	6	6	6	6	7	5	6	6	6	6	6
6	6	7	5	6	6	6	7	5	6	6	6	6	7	5	6	6	6	6	6
6	6	7	5	6	6	6	7	5	6	6	6	6	7	10	11	11	11	11	11
6	6	7	5	6	6	6	7	5	6	6	6	6	8	1	1	1	1	1	1
6	6	7	10	11	11	11	12	5	6	6	6	6	6	6	6	6	6	6	6
6	6	8	1	1	1	1	1	9	6	6	6	6	6	6	6	6	6	6	6
6	6	6	6	6	6	6	6	6	6	6	6	6	6	6	6	6	6	6	6
200
SmallBush   16  4
SmallBush   40  24
BigBush     72  40
StarBush    68  24
SmallRock   48  16
BigRock     4   40
wave	0
SmallerEnemy	30	-1	1	60
wave	1
NormalEnemy	    30	-1	1	60
wave	2
SmallerEnemy	15	-1	1	60
NormalEnemy	    15	-1	1	60
wave	3
NormalEnemy	    20	-1	1	60
TankerEnemy	    10	-1	1	60
wave	4
NormalEnemy	    10	-1	1	60
SmallerEnemy	10	-1	1	60
BossEnemy	    1	-1	1	60
wave 5